- - ~ - - ~ ~ - - - 
- - ~ - - ~ ~ - - - 
- - ~ - - ~ ~ - - - 
- - ~ ~ - ~ - - - - 
- - - ~ - ~ ~ - - - 
- - - - - ~ ~ - - - 