- - ~ - - ~ ~ - - - 
- - ~ - - ~ ~ - - - 
- = ~ - - ~ ~ - - - 
- = ~ ~ - - - - - - 
- - - ~ - ~ ~ - - - 
- - - - - ~ ~ - - - 