- - ~ - - ~ ~ - - - 
- - ~ - - ~ ~ - - - 
- - ~ - - ~ ~ - - - 
- - y ~ - - - - - - 
- - - ~ - ~ ~ - - - 
- - - - - ~ ~ - - - 