- - ~ - - ~ ~ - - - 
- - ~ - - ~ ~ - - - 
- - ~ - - ~ ~ - - - 
- - ~ ~ - - - - - - 
- - - - - ~ ~ - - - 
- - - - - ~ ~ - - - 