- - ~ - - ~ ~ - - - 
- - ~ - - ~ ~ - - - 
- - ~ - - ~ ~ - - - 
- - ~ ~ - - - - - - 
- - - ~ - ~ ~ - - - 
- - - - - ~ ~ - - - 
- -
- -
- ~