- - ~ - - ~ ~ - - - 

- - ~ - - ~ ~ - - - 
- - ~ ~ - - - - - - 
- - - ~ - ~ ~ - - - 
- - - - - ~ ~ - - - 