- - ~ - - ~ ~ - - - 
- - ~ - - ~ ~ - - - 
- - ~ - - ~ ~ - - - 
- - ! ! - - - - - - 
- - - ~ - ~ ~ - - - 
- - - - - ~ ~ - - - 